F       120,40,31 
C       174,214,241
WE      textures/NO.xpm
SO      textures/WE.xpm
NO      textures/SO.xpm
EA      textures/EA.xpm

11111111111111111111111111111111111
10000000000000000000000000000000001
10000000000000000010000000000100001
10000010000000000000000000001000001
10000000000000000000000000001000001
10000000000000000000000000000000001
10000000100000000000000000000000001
100000001111111D1111111110000000001
10000000100000000000000100000000001
10000000100000000000001000000000001
10000000100000000000000000000000001
10000000100000000000000000100000001
100000001000000N0000000000000000001
10000000000000000000000111110000001
10000000000000000000000000000000001
11111111111111111111111111111111111